1111111111
10000P0001
1010100C01
1010111111
1011C00E01
1010101101
1000000001
1111111111