11111111111111
100000000C0001
11011111111111
110111111000E1
11000000000001
110000000000P1
11111111111111