1111111111
1000C01001
1P100C0111
10001101E1
1C10011101
1000000001
1111111111