111111
100001
1000C1
1P00E1
111111